10 10
1 9
8 1
X 2 3 3 3 5 3 1 3 X
X X X 2 2 2 1 3 X 7
3 3 1 2 1 6 3 X X 1
X 1 7 1 X 1 3 3 3 2
3 1 1 5 3 8 2 1 4 1
1 3 8 2 2 1 X 4 2 6
X X 4 6 X 1 5 5 X 5
3 1 2 2 X 1 3 1 3 X
2 1 3 1 1 3 4 1 1 2
6 1 3 1 1 8 2 X 1 1