10 10
9 10
1 1
4 2 X 5 2 X X 2 3 1
4 5 2 X 2 3 2 3 X 5
3 6 3 3 2 2 2 X 5 3
1 2 1 X X 1 5 1 3 X
X 1 3 1 1 3 1 X X 1
2 X 3 2 3 2 4 3 3 6
2 1 X 5 4 4 3 3 3 3
1 1 1 X 5 3 3 1 X 7
X 2 8 1 6 X X 2 4 2
6 3 3 1 1 X 1 X 1 1